{||}    {||}{||}{||}{||}{||}
{||}                    {||}
{||}{||}{||}{||}{||}    {||}
{||}            {||}    {||}
{||}    {||}{||}{||}    {||}
{||}                    {||}
{||}{||}{||}{||}{||}    {||}
